4 4 4 4 4 4 4 4 4 4 4 4 4 4 4 4 4 4 4 4 4 4 4 4 4 4 4 4 4 4 4 4 4
4 4 4 4 4 4 4 4 4 4 4 0 0 0 0 0 0 0 0 0 0 0 0 0 0 0 0 0 0 0 0 0 4
4 4 4 4 4 4 4 4 4 4 4 0 0 0 0 0 0 0 0 0 0 0 0 0 0 0 0 0 0 0 0 0 4
4 4 4 4 4 4 4 4 4 4 4 0 0 0 0 0 0 0 0 0 0 0 0 0 0 0 0 0 0 0 0 0 4
4 4 4 4 4 4 4 4 4 4 4 0 0 0 0 0 0 0 0 0 0 0 0 0 0 0 0 0 0 0 0 0 4
4 4 4 4 4 4 4 4 4 4 4 0 0 0 0 0 1 1 1 1 1 1 1 1 1 1 1 1 0 0 0 0 4
4 0 0 0 0 0 0 0 0 0 0 0 0 0 0 0 0 4 0 0 0 0 0 0 0 0 0 0 0 0 0 0 4
4 0 0 0 0 0 0 0 0 0 0 0 10 10 0 0 0 4 0 0 0 0 0 0 0 0 0 0 0 0 0 0 4
4 0 0 100 0 0 0 0 0 0 0 0 0 0 0 0 1 4 0 0 0 0 0 0 0 0 0 0 12 12 12 0 4
4 0 0 0 0 0 0 9 9 0 0 0 0 0 0 1 4 0 0 0 0 0 0 0 0 0 0 0 0 0 0 0 4
4 2 2 2 2 2 2 2 2 2 2 2 2 2 2 4 0 0 0 0 0 0 0 0 0 0 12 0 0 0 0 0 4
4 0 4 0 0 0 4 0 0 0 0 0 0 0 0 0 0 0 0 0 0 0 0 0 0 0 0 0 0 0 0 0 4
4 0 4 0 0 0 4 0 0 0 0 0 0 0 0 0 0 0 0 0 12 12 12 12 0 0 0 0 0 0 0 0 4
4 0 4 0 0 0 4 0 0 0 0 0 0 0 0 0 0 0 2 0 0 0 0 0 0 0 0 0 0 0 0 0 4
4 0 0 0 0 0 0 0 0 0 0 0 0 0 0 12 0 0 4 15 15 15 15 15 15 15 15 15 15 15 15 15 4
4 0 0 0 2 0 0 0 2 0 0 0 12 0 0 0 0 9 4 0 0 0 0 0 0 0 0 0 0 0 0 0 4
4 0 0 0 4 0 0 0 4 0 0 0 0 0 0 0 9 4 4 0 0 0 0 0 0 0 0 0 0 0 0 0 4
4 0 0 0 2 2 2 2 2 2 2 2 9 9 9 9 4 4 4 0 0 0 0 0 0 0 0 0 0 0 0 0 4
4 0 0 0 2 0 0 0 0 0 0 0 4 4 4 4 0 0 0 0 0 0 0 0 0 0 0 0 0 0 0 0 4
4 0 0 0 2 0 0 0 0 0 0 0 0 0 0 0 0 0 0 0 0 0 0 0 4 0 0 0 0 0 0 0 4
4 0 0 0 2 0 0 0 0 0 0 0 0 0 0 0 0 0 0 12 12 12 0 0 4 0 0 0 0 0 0 0 4
4 0 0 0 2 0 0 0 1 1 0 0 0 0 0 0 0 0 0 0 0 0 0 0 4 0 0 0 0 0 0 0 4
4 0 0 0 2 0 0 0 0 0 1 1 1 1 1 1 0 0 0 0 0 0 0 2 4 0 0 0 0 0 0 0 4
4 0 0 0 2 0 12 0 0 0 4 0 0 0 0 0 0 0 0 0 0 0 0 0 4 0 0 0 0 0 0 0 4
4 0 0 0 2 0 0 0 0 0 4 0 0 0 0 0 0 0 12 12 12 12 0 0 4 0 0 0 0 0 0 0 4
4 0 0 0 0 0 0 0 2 2 4 0 0 0 0 0 0 0 0 0 0 0 0 0 4 0 0 0 0 0 0 0 4
4 0 0 0 0 0 0 0 0 2 4 0 0 0 0 0 2 0 0 0 0 0 0 0 4 0 0 0 0 0 0 0 4
4 0 0 0 0 0 12 0 0 2 4 2 2 2 2 4 2 2 2 2 2 2 2 2 4 0 0 0 16 0 0 0 4
4 0 0 0 0 0 0 0 0 2 4 0 0 0 0 0 0 0 0 0 0 0 0 0 4 0 0 0 0 0 0 0 4
4 4 4 4 4 4 4 4 4 4 4 4 4 4 4 4 4 4 4 4 4 4 4 4 4 4 4 4 4 4 4 4 4
4 4 4 4 4 4 4 4 4 4 4 4 4 4 4 4 4 4 4 4 4 4 4 4 4 4 4 4 4 4 4 4 4